1111111
111C111
1C0P0E1
111C111
1111111