111111111111111
1C100C001101001
10C00000C101101
1001C0011100001
111110000101111
10C010000101001
101P10010101101
101110010100001
10000001E101111
111111111111111