111111111111111
1C000C000100001
10C00000C100001
1000C0011100001
111110000100001
10C010000100001
101P10010101001
101110010100001
10000001E100001
111111111111111