1111111111
1C00P0C0E1
1111111111