111111111111
1C00P0C000E1
111111111111