11111111111111111111111
1C0C0C0C0P0C0C0E0000001
11111111111111111111111