11111111111111111111
1C100C00110100111111
10C00000C10110111111
1001C001110000111111
11111000010111111111
10C01000010100111111
101P1001010110111111
10111001010000111111
10000001011111111111
1000000100000E111111
11111111111111111111