11111111111111111111
1EP10001C00000000001
11010101111111111101
10010101000100000001
10110101010101111101
10000100010001C00001
11111111111111111101
1C100010000000010101
10101010101111010001
100010001000C10001C1
11111111111111111111