1111111
10BCBE1
1C0PB01
1B0C001
1111111