1111111111
1000000001
10P00000C1
1000C00111
1111100001
10C0100001
1000100101
1011100101
10000001E1
111111111